########################################
#......................................#
#....@.................................#
#...............................#......#
#.................................M....#
#......................................#
#.............#........................#
#.####........#........................#
#....#........##.......................#
#..............#.......................#
#......................................#
#...............M...............*......#
#......................................#
#......................................#
#..........................###.........#
#....................#######...........#
#.........................#............#
#.....................M...#............#
#......................................#
########################################
